1111111111111111111111111111111111111111111
1000P00000100000000000010000000000000000C01
1000000000100000000000010000000000000000001
1111110000100000000000000000000111111111111
10000000001111100000000X0000000000000000001
1000000000000010000000000000000000000000001
1000000000000010000000010000000000000000001
1000000000000010000000011111111111000000001
1000000000000000000000000000000011000000001
100000000000000000000000000000001100000E001
1111111111111111111111111111111111111111111
