11111111111111111111111
1E0000000000001C1001001
1C000000000000C0C010001
1CCCCCC000000C000C10001
1C000000000000C0C010001
100000000000000C00101P1
11111111111111111111111
