11111111111111111111111
100000E0P000C0X00000001
10000101001000001010001
10100100101010100011001
11111111111111111111111
