11111111111111111111111
100000E1P00000X00000C01
10000101001000001010001
10100100101010100011001
11111111111111111111111
