11111111111111111111111
1E000000P000000C00000C1
10100101001000001010001
10100100101010100011001
11111111111111111111111
